1111111111111111111
111111P011111111\n1
1111110C00111111111
1000C00000C0000C001
10000000000000E0001
1C0000C00000C000001
1000C00111100000001
11110001111100000C1
1111111111111111111
1111111111111111111
