11111111111111111111111111111111111111111111111111111111
1P0000C000000C000000C000000000C000000C0000000C00000C00E1
11111111111111111111111111111111111111111111111111111111
